12 15
XXXXXXXXXXXXXXX
X|-----------|X
X|-|||||||||-|X
X|-|---#---|-|X
X|-|-|||||-|-|X
X|-|-|-|-|-|-|X
X|-|.|.|.|.|-|X
X|-#-+-+-+-#-|X
X|.|-|||||-|.|X
X|-|---#---|-|X
X|||||||||||||X
XXXXXXXXXXXXXXX
7
H 7 1 S -
H 6 3 S -
B 7 5 N |
A 10 10 S |
C 7 7 S +
X 11 2 S |
T 7 4 S |